# # # # # # # # # # # # # # # # # # # # # # # # # # # # # # # # . . . . . # # # . . . . # # # # # # # # # # # # # # # # # # # # # # # # # # # # # # # # # # # # 
# # # # # # # # # # # # # # # # # # # # # # # # # # # # # # # # . . . . . . . # . . . . . # # # # # # # # # # # # # # # # # # # # # # # # # # # # # # # # # # # 
# # # # # # # # # # # # # # # # # # # # # # # # # # # # # # # # # . . . . . . . # . . . . # # # # # # # # # # # # # # # # . # # # # # # . . # # # # # # # # # # 
# # # # # # # # # # # # # # . # # # # # # # # # # # # # # # # # # # . . . . . # # . # # . . # # # # # # # # # # # # # # # . . # # # . . . . # # # # # # # # # # 
# # # # # # # # # # # # # # . . # # # # # # # # # # # # @ @ @ @ . . . . . . . . # . # # # . # # # # # # # # # # # # # # # . . . # # . . . . . # # # # # # # # # 
. . . . . . . . . . . . . . . . . . . . . . . . . . . . @ @ @ @ . . . . . . . . . . . . . . . # # # . . . # # # # # # # # # . . . . . . . . . . . # # # # # # # 
. . . . . $ . . . . . . . . . . . . . . . . . . . . . . @ @ @ @ . . . . . . . . . . . . . . . . . . . . . # # # # # # # # # . . . . . . . . . . . . # # # # # # 
# . . . . $ . # # . . . . . # . . . # # # # # # # # # # @ @ @ @ . . . . . . . . . . . . . . . # # . . . . . # # # # # # # . . . . . . . . . . . . # # # # # # # 
# $ . . . . . . # . . . . . . . . . # # # # # # # # # # # . . # . . . . . . . . . . . . # # # . # . . . . # # # # # # # # . . . . . . . . . . . . # # # # # # # 
. $ . . . . . . . $ . . . . . . . # # # # # # # # # # # # . . # . . . . . . . . . . . . . . . . . . . . . # # # # # # # # # . . . . . . . . . . # # # # # # # # 
# # . . . . . # . . . . . . . . # # # # # # # # # # # # # . . # # . . . . . . . . . . . . . # . . # . . . # # # # # # # . . . . . . . . . . . # # # # # # # # # 
# # . # . . . . . . . . $ . . . # # # # # # # # # # # # # . . # . . . . . . . . . . . . . . # # . # . . . . # # # # # # . . . . . . . . . . . # # # # # # # # # 
. . . . # # # # # . . # # # # # # # # # # # . . . . . . # # # # # # # # # # # # # # # # # # # # # # # # # # # # # # # # # # # # # # # # # . . # # # # # # # # # 
. . . . . # # # # . . # # # # # # # # # # # # . . . . # # # # # # # # # # # # # # # # # # # # # # # # # # # # # # # # # # # # # # # # # # . . # # # # # # # # # 
$ . . . . . . # # . . # # # # # # # # # # # # . . . . # # # # # # # # # # # # # # # # # # # # # # # # # # # # # # # # # # # # . . . . . . . . . . . . . . # # # 
# . . . . . . . # . . # # # # # # # # # . . . . . . . # # # # # # # # # # # # # # # # # # # # # # # # # # # # # # # # # # # . V . . . . . . . . . . . . V . # # 
. . . . . . . # # . . # # # # # # # # # . . . . . . . # # # # # # # # # # # # # # # # . . . # # # # # # # # # # # # # # # # . . . . . . . . . . . . . . . . # # 
. . . . . . . . . . . . . . . . . . . . . . . . . . . . . . . . . . . . . . . . . . . . . . . . . . . . . . . . . . . . . . . . . . . . . # # . . . . . . . . . 
. . . $ . $ . . . . . . . . . . . . . . . . . $ . $ . . . . . . . . . . . . . . . . . $ . $ . . . . . . . . . . . . . . . . . . . . . . . # # . . . . . . . . . 
. . . . . $ . . . . . . # # # # # # # # . . . . . $ . . . . . # # # # # # # # # . . . . . # . . . # # # # # . . # # # . # # . . . . . . . . . . . . . . . . # # 
. $ . . # . . # # . . . # # # # # # # # . $ . . . . . . . # # # # # # # # # # # . $ . . . . . . # . . # # # . . . . . . # # . V . . . . . . . . . . . . V . # # 
. $ . . . . . . # # # . # # # # # # # # . $ . . . # . . . $ # # # # # # # # # # . $ . . . . . . # $ . # # . . $ . . . . # # # . . . . . . . . . . . . . . # # # 
. . . . . . . . # # # # # # # # # # # # . . . . . . . . . . # # # # # # # # # # . . . . . . . . . . . # # . . . . . . . # # # # # # # # # . . # # # # # # # # # 
. . . . # # # # # # # # # # # # # # # # . . . . . . . . . . . # # # # # # # # # . . . . . . . . . . . . $ . # # # . . . # # # # # # # # # . . # # # # # # # # # 
# # # # # # # # # # # # # # . . . $ . . # # # # # # # # # # # # . . . . . $ . $ # # # # # # # # # . . . . . . . . # # # # # # # # # # # # # # # # # # # # # # # 
# # # # # # # # # # # # # # . . . . . . # # # # # # # # # # # # . . . . . . . . # # # # # # # # # . . . . . . . . # # # . . # # # # # # # # . # # # # # # # # # 
# # # # # # # # # # # # # . . . . . . . # # # # # # # # # # # # . . . . # . . . # # # # # # # # # . . . . . . . . # # # . . # # # # # # . . . # # # # # # # # # 
# # # # # # # # # # . . . . . . . . . . # # # # # # # # # # # # . . . . # . . # # # # # # # # # # . . . . . . . . # # # # . # # # # # . . . . . . # # # # # # # 
# # # # # # # # # # # . $ . . . . . . . # # # # # # # # # . . . $ . # . # . . . # # # # # # # # . . . . $ . . . # # # # # . # # # # . . . . . . . # # # # # # # 
. . . . . . . . . . . . . . . . . . . . . . . . . . . . . . . . . . . . . . . . . . . . . . . . . . . . . . . . . . . . # . # # . . . . . . . . . # # # # # # # 
. . . $ . $ . . . . . . . . . . . . . . . . . $ . $ . . . . . . . . . . . . . . . . . . . $ . . . . . . . . . . . . . . . . . . . . . . . . . . . # # # # # # # 
# # # # # # # # # # . . . . . . . . . . # # # # # # # . . # . . . . . . . . # # # # . . . $ . . . . . . . . . # # # # # . . . . . . . # . . . . . . # # # # # # 
# # # # # # # # # . . # . . . . . . . # # # # # # # # . . . . # # # . . . . . # . $ . # # . # . . . . . # . # # # # # # . . . . . . . . . . # # # . # # # # # # 
# # # # # # # # . $ . . $ # . $ . . . # # # # # # # # . # $ . # # # # $ . . . # # # # # # # # # # $ . . $ . . # # # # # . . . . . . . . . . # # # # # # # # # # 
# # # # # # # # . . . . . # # # . . . # # # # # # # # # # # # # # # . . . . . . # # # # # # # # # # . . . . # # # # # # . . . . . . . . . # # # # # # # # # # # 
# # # # # # # # # . . . # # # # # . # # # # # # # # # # # # # # # # . . . . . . # # # # # # # # # # . # # # # # # # # # . . . . . . . . # # # # # # # # # # # # 
# # # # # # # # # . . # # # # . . $ # # # # # # # # # # # . . # # # # # # # # # . . . . . # # # # # # # # # # # # # # # # # # # # # # # # . . # . . # # . # # # 
# # # # # # # # # . . # # # . . . . . # # # # # # # # # # . . # # # # # # # # # . . . . . . . . # # # # # # # # # # # # # # # # # # # # # . . # . . . . . # # # 
# # # # # # # # # . . # . . . . . . . . # # # . . . . . . . . . . . . . . # # # # . . . . . . . . # # . # # # # # # # # # # # # # # # # . . . . . . . # # # # # 
# # # # # # # # # . . # . . # . . . . . # # . S . . . . . . . . . . . . C . # # # . . . . . . . . . . . # # # # # # # # # # # # # # # . . . . . . . . . # # # # 
# # # # # # # # . . . # # # # . . . . . # # . . . . . . . . . . . . . . . . # # # # . . . . $ # . # . # # # # # # # # # # # # # # # # . @ @ @ @ # . . . # # # # 
. . . . . . . . . . . . . . . . . . . . . . . . . . . . . K B . . . . . . . . . . . . . . . . . . . . . . . . . . . . . . . . . . . . . @ @ @ @ . . . . . . . . 
. . . $ . $ . . . . . . . . . . . . . . . . . . . . . . . B K . . . . . . . . . . . . $ . $ . . . . . . . . . . . . . . . . . . . . . . @ @ @ @ . . . . . . . . 
# # # # # # # # # . . # . . . . . . . . # # . . . . . . . . . . . . . . . . # # # # . . . # # . . . . . # # # # # # # # # . . . . . . . @ @ @ @ # . . . . . # # 
# # # # # # # # # . . # . . . . . . . . # # . C . . . . . . . . . . . . S . # # # # # . . . . . . . # . # # # # # # # # . . . . . . . . . . . # # # # # # # # # 
# # # # # # # # # # . . $ . . $ . . . . # # # . . . . . . . . . . . . . . # # # # # # . . . . . . $ # . $ # # # # # # # # . . . . . . . . # # # # # # # # # # # 
# # # # # # # # # # . . . . . . . . . . # # # # # # # # # . . # # # # # # # # # # # # # # . . . . # . # . . . # # # # # . . . . . . . . . . # # # # # # # # # # 
# # # # # # # # # # . . $ . . . . . . . # # # # # # # # # . . # # # # # # # # # # # # # # . . . . . . . $ . . # # # # # . . . . . . . . . . # # # # # # # # # # 
