# # # # # # # # # . . # # # # # # # # # 
# # # # # # # # # . . # # # # # # # # # 
# # # . . . . . . . . . . . . . . # # # 
# # . V . . . . . . . . . . . . V . # # 
# # . . . . . . . . . . . . . . . . # # 
. . . . . . . . . # # . . . . . . . . . 
. . . . . . . . . # # . . . . . . . . . 
# # . . . . . . . . . . . . . . . . # # 
# # . V . . . . . . . . . . . . V . # # 
# # # . . . . . . . . . . . . . . # # # 
# # # # # # # # # . . # # # # # # # # # 
# # # # # # # # # . . # # # # # # # # # 